1111111111
1C00C00C01
10C0C0C0C1
1CEC0000P1
1111111111
