11111111111111
1000C00000P001
10000000000E01
10000000000001
11111111111111
