111111111111111111
1000C00000P00000E1
100000000000000001
100000000000000001
100000000000000001
100000000000000001
100000000000000001
111111111111111111
