1111111111111111111111111111111
10EC000000P00000000000000000001
1111111111111111111111111111111
