1111111111111
1P000E000C001
1000010010001
1111111111111
